00000000000000000000000000000000000000000000000000000000000000000000000000000000
00000000000000000000000000000000000000000000000000000000000000000000000000000000
00000000000000000000000000000000000000000000000000000000000000000000000000000000
00000000000000000000000000000000000000000000000000000000000000000000000000000000
00000000000000000000000000000000000000000000000000000000000000000000000000000000
00000000000000000000000000000000000000000000000000000000000000000000000000000000
00000000000000000000000000000000000000000000000000000000000000000000000000000000
00000000000000000000000000000000000000000000000000000000000000000000000000000000
00000000000000000000000000000000000000000000000000000000000000000000000000000000
00000002222222222222222222222222222222222222222200000000000000000000000000000000
00000002000000000000000000000000005000005000000200000000000000000000000000000000
00000002010000000000000000000000000000000000000200000000000000000000000000000000
00000002000000000300003000030000000000000000000200000000000000000000000000000000
00000002222222222222222222222222222222222222000200000000000000000000000000000000
00000000000000000000000000000000000000000002000220000000000000000000000000000000
00000000000000000000000000000000000000000002050022222222222222222222200000000000
00000000000000000000000000000000000000000002000000000000000500000000200000000000
00000000000000000000000000000000000000000002000000000000000000000000200000000000
00000000000000000000000000000000000000000002000000000030000000000000200000000000
00000000000000000000000000000000000000000002030022222222222222222000200000000000
00000022222222222222222222222222222222222222000220000000000002222000200000000000
00000020000005000000000000020000000030000000000200000000000002000000200000000000
00000020800000000004000400000000000030000000000200000000000002000000200000000000
00000020000000000004444400000000000000000000000200000000000002000333200000000000
00000022222222222222222222222222222222222222222200000000000002222000200000000000
00000000000000000000000000000000000030000000000000000000000000002000200000000000
00000000000000000000000000000000000030000000000000000000000000002000200000000000
00000000000000000000000000000000000000000000000000000000000000042000260000000000
00000000000000000000000000000000000000000000000000000000000000002000200000000000
00000000000000000000000000000000000000000000000000000000000000042000260000000000
00000000000000000000000000000000000000000000000000000000000000002000200000000000
00000000000000000000000000000000000000000000000000000002222200042000260000000000
00000000000000000000000000000000000000000000000000000002000200002000200000000000
00000000000000000000000022222222222222222222222222222222000222222000200000000000
00000000000000000000000020000000000500000000000005500000400000000000200000000000
00000000000000000000000020000000000000000000000000000000400000000000200000000000
00000000000000000000000020000000300000300000000000000000400000000000200000000000
00000000000000000000000020002222222222222200022222222222222222222222200000000000
00000000000000000000000020002000000000000200020000000000000000000000000000000000
00000000000000000000000020062000000000004200620000000000000000000000000000000000
00000000000000000000000020002000000000000200020000000000000000000000000000000000
00000000000000000000000020002000000000000200020000000000000000000000000000000000
00000000000000000000000020002000000000000200020000000000000000000000000000000000
00000000000000000000000020062000000000004200620000000000000000000000000000000000
00000000000000000000000020002000000000000200020000000000000000000000000000000000
00000000000000000000000020002000000000000200020000000000000000000000000000000000
00000000000000000000000020002000000000000240026000000000000000000000000000000000
00000000000000000000000020062000000000000200020000000000000000000000000000000000
00000000000000000000000020002000000000000208020000000000000000000000000000000000
00002222222222222222222220002000000000000200020000000000000000000000000000000000
00002000000000000030000000002000000000000222220000000000000000000000000000000000
00002000000050000030000000002000000000000000000000000000000000000000000000000000
00002000000050000000000000002000000000000000000000000000000000000000000000000000
00002000222222222222222220002000000000000000000000000000000000000000000000000000
00002005200000000000000020002222000000000000000000000000000000000000000000000000
00002300200000000000000024000002000000000000000000000000000000000000000000000000
00002000200000000000000024000002000000000000000000000000000000000000000000000000
00002005200000000000000024000002000000000000000005000000000000000000000000000000
00002300200000000000000020002222222222222200022222222222222222222222222200000000
00002000200000000000000020000000000000000200020000000000000000000000000200000000
00002005200000000000000020000000000000070200020800000000000040000000000200000000
00002300200000000000000020000000000000000200020000000000000030000055000200000000
00002000200000000000000022222222222222222200022222222222222222222200000200000000
00002005200000000000000000000000000000000000000003000000000000000200000200000000
00002300200000000000000000000000000000000000000000000000000000000200555200000000
00002000200000000000000000000000000000000000000000000000000000000200000200000000
00002005200000000000000000000000000000000000000000000000000000000200000200000000
00002300200000000000000000000000000000000000000000000000000000000255000200000000
00002000200000000000000000000000000000000000000000000000000000000200000200000000
00002000222222222222222222222222222222222222222222222222222222222200000200000000
00002000000000000000000000000000000000500005000500050000000000022200000200000000
00002000000000000000000000000000000000000000000000000000024000622200000200000000
00002000000033300003330003330033300000300003000300030000020000000000000200000000
00002222222222222222222222222222222222222222222222222222222222222222222200000000
00000000000000000000000000000000000000000000000000000000000000000000000000000000
00000000000000000000000000000000000000000000000000000000000000000000000000000000
00000000000000000000000000000000000000000000000000000000000000000000000000000000
00000000000000000000000000000000000000000000000000000000000000000000000000000000
00000000000000000000000000000000000000000000000000000000000000000000000000000000
00000000000000000000000000000000000000000000000000000000000000000000000000000000